;Do whatever to ignore this




#############
#       d   #
#    c      #
#       x   #
#           #
#    ooo    #
#           #
#############


#######
#     #
#######



    ######
#####    #
#        #
#        #
##########